id,player,total_games,total_wins,total_losses,total_win_percentage,regular_season_games,regular_season_wins,regular_season_losses,regular_season_win_percentage,playoffs_games,playoffs_wins,playoffs_losses,playoffs_win_percentage
jonesju01,Jumaine Jones,226,78,148,.345,224,78,146,.348,2,0,2,.000
davisri01,Ricky Davis,204,63,141,.309,200,63,137,.315,4,0,4,.000
odomla01,Lamar Odom,160,94,66,.588,159,93,66,.585,1,1,0,1.000
bryanko01,Kobe Bryant,159,91,68,.572,158,90,68,.570,1,1,0,1.000
ilgauzy01,Zydrunas Ilgauskas,142,45,97,.317,142,45,97,.317,0,0,0,
waltolu01,Luke Walton,138,74,64,.536,137,73,64,.533,1,1,0,1.000
millean02,Andre Miller,132,45,87,.341,132,45,87,.341,0,0,0,
vujacsa01,Sasha Vujačić,128,74,54,.578,127,73,54,.575,1,1,0,1.000
cookbr01,Brian Cook,128,64,64,.500,128,64,64,.500,0,0,0,
murrala01,Lamond Murray,118,42,76,.356,118,42,76,.356,0,0,0,
persowe01,Wesley Person,110,40,70,.364,110,40,70,.364,0,0,0,
atkinch01,Chucky Atkins,103,46,57,.447,99,46,53,.465,4,0,4,.000
parkesm01,Smush Parker,99,41,58,.414,99,41,58,.414,0,0,0,
colesbi01,Bimbo Coles,91,29,62,.319,91,29,62,.319,0,0,0,
brownti01,Tierre Brown,84,36,48,.429,84,36,48,.429,0,0,0,
diopde01,DeSagana Diop,84,22,62,.262,84,22,62,.262,0,0,0,
langdtr01,Trajan Langdon,83,24,59,.289,83,24,59,.289,0,0,0,
milesda01,Darius Miles,73,17,56,.233,73,17,56,.233,0,0,0,
butleca01,Caron Butler,70,31,39,.443,70,31,39,.443,0,0,0,
boozeca01,Carlos Boozer,68,17,51,.250,68,17,51,.250,0,0,0,
bynuman01,Andrew Bynum,62,43,19,.694,62,43,19,.694,0,0,0,
grantbr01,Brian Grant,62,26,36,.419,62,26,36,.419,0,0,0,
georgde01,Devean George,60,29,31,.483,60,29,31,.483,0,0,0,
weathcl01,Clarence Weatherspoon,59,19,40,.322,59,19,40,.322,0,0,0,
skinnbr01,Brian Skinner,59,19,40,.322,59,19,40,.322,0,0,0,
welscji01,Jiří Welsch,58,21,37,.362,54,21,33,.389,4,0,4,.000
blounma01,Mark Blount,58,21,37,.362,54,21,33,.389,4,0,4,.000
mccarwa01,Walter McCarty,58,21,37,.362,54,21,33,.389,4,0,4,.000
banksma01,Marcus Banks,58,21,37,.362,54,21,33,.389,4,0,4,.000
piercpa01,Paul Pierce,56,20,36,.357,52,20,32,.385,4,0,4,.000
brownkw01,Kwame Brown,54,29,25,.537,54,29,25,.537,0,0,0,
stewami01,Michael Stewart,54,12,42,.222,53,12,41,.226,1,0,1,.000
gatlich01,Chris Gatling,52,17,35,.327,52,17,35,.327,0,0,0,
palacmi01,Milt Palacio,52,11,41,.212,52,11,41,.212,0,0,0,
traylro01,Robert Traylor,48,15,33,.312,48,15,33,.312,0,0,0,
stithbr01,Bryant Stith,46,14,32,.304,46,14,32,.304,0,0,0,
harprma01,Matt Harpring,45,17,28,.378,45,17,28,.378,0,0,0,
fishede01,Derek Fisher,42,32,10,.762,41,31,10,.756,1,1,0,1.000
medvest01,Stanislav Medvedenko,39,9,30,.231,39,9,30,.231,0,0,0,
farmajo01,Jordan Farmar,39,29,10,.744,38,28,10,.737,1,1,0,1.000
huntebr01,Brandon Hunter,38,13,25,.342,35,13,22,.371,3,0,3,.000
radmavl01,Vladimir Radmanović,37,28,9,.757,36,27,9,.750,1,1,0,1.000
hendece02,Cedric Henderson,35,10,25,.286,35,10,25,.286,0,0,0,
doleami01,Michael Doleac,34,11,23,.324,34,11,23,.324,0,0,0,
wagneda02,Dajuan Wagner,31,4,27,.129,31,4,27,.129,0,0,0,
jacksji01,Jim Jackson,30,8,22,.267,30,8,22,.267,0,0,0,
turiaro01,Ronny Turiaf,28,15,13,.536,27,14,13,.519,1,1,0,1.000
hillty01,Tyrone Hill,27,9,18,.333,27,9,18,.333,0,0,0,
jamesmi01,Mike James,27,8,19,.296,27,8,19,.296,0,0,0,
arizatr01,Trevor Ariza,26,23,3,.885,25,22,3,.880,1,1,0,1.000
profila01,Laron Profit,25,14,11,.560,25,14,11,.560,0,0,0,
greende01,Devin Green,24,12,12,.500,24,12,12,.500,0,0,0,
ollieke01,Kevin Ollie,22,6,16,.273,22,6,16,.273,0,0,0,
jamesle01,LeBron James*,22,6,16,.273,22,6,16,.273,0,0,0,
gasolpa01,Pau Gasol,21,20,1,.952,20,19,1,.950,1,1,0,1.000
johnsan02,Anthony Johnson,20,6,14,.300,20,6,14,.300,0,0,0,
bremejr01,J.R. Bremer,19,5,14,.263,19,5,14,.263,0,0,0,
newblir01,Ira Newble,18,7,11,.389,18,7,11,.389,0,0,0,
brownch01,Chucky Brown,18,3,15,.167,18,3,15,.167,0,0,0,
poweljo01,Josh Powell,15,14,1,.933,15,14,1,.933,0,0,0,
wafervo01,Von Wafer,14,6,8,.429,14,6,8,.429,0,0,0,
kaponja01,Jason Kapono,13,4,9,.308,13,4,9,.308,0,0,0,
rushka01,Kareem Rush,13,8,5,.615,13,8,5,.615,0,0,0,
bakervi01,Vin Baker,12,4,8,.333,12,4,8,.333,0,0,0,
mckieaa01,Aaron McKie,11,6,5,.545,11,6,5,.545,0,0,0,
divacvl01,Vlade Divac,10,6,4,.600,10,6,4,.600,0,0,0,
trepaje01,Jeff Trepagnier,10,2,8,.200,10,2,8,.200,0,0,0,
crittja01,Javaris Crittenton,8,6,2,.750,8,6,2,.750,0,0,0,
perkike01,Kendrick Perkins,8,3,5,.375,8,3,5,.375,0,0,0,
evansma01,Maurice Evans,5,3,2,.600,5,3,2,.600,0,0,0,
mbengdj01,D.J. Mbenga,4,3,1,.750,4,3,1,.750,0,0,0,
knighbr01,Brevin Knight,3,1,2,.333,3,1,2,.333,0,0,0,
yuesu01,Sun Yue,3,3,0,1.000,3,3,0,1.000,0,0,0,
hawkimi01,Michael Hawkins,3,1,2,.333,3,1,2,.333,0,0,0,
sundobr01,Bruno Šundov,3,0,3,.000,3,0,3,.000,0,0,0,
karlco01,Coby Karl,2,1,1,.500,2,1,1,.500,0,0,0,
barroda01,Dana Barros,2,1,1,.500,1,1,0,1.000,1,0,1,.000
reidjr01,J.R. Reid,2,1,1,.500,2,1,1,.500,0,0,0,
bobbito01,Tony Bobbitt,2,0,2,.000,2,0,2,.000,0,0,0,
brownsh01,Shannon Brown,1,1,0,1.000,1,1,0,1.000,0,0,0,
mccoyje01,Jelani McCoy,1,0,1,.000,1,0,1,.000,0,0,0,
robinla01,Larry Robinson,1,0,1,.000,1,0,1,.000,0,0,0,
morriad01,Adam Morrison,1,1,0,1.000,1,1,0,1.000,0,0,0,
